%%%%%%%%%%%%%%%%%%%%%%%%%
%..    ....      .... G %
%..  ...  ...  ...  ... %
%..  ...  ...  ...  ... %
%.. P  ....      ....   %
%..  ...  ...  ...  ... %
%..  ...  ...  ...  ... %
%..    ....      .... G %
%%%%%%%%%%%%%%%%%%%%%%%%%
